############+>-v-v-v-v+v
############->        -<
############->        -<
############->        -<
############->        -<
############->        -<
############->        -<
############->        -<
############->        -<
############->        -<
############->        -<
############->        -<
############->        -<
############->  L^L>  -<
############+^-^+<+^-^+<
